Siglas dos setores PRC

AAI – Assessoria de Apoio Integrado
ACS – Assessoria de Comunicação Social
AES – Assessoria Especial da Superintendência
AGE - Assessoria de Governança e Gestão Estratégica
APE – Assessoria de Programas Especiais
ARI – Assessoria de Relações Institucionais
ASI – Assessoria de Sistemas da Informação
ATO – Assessoria Técnica Operacional
CAD – Coordenadoria Administrativa
CDIM - Coordenadoria de Desenvolvimento Institucional Municipal
CECR – Coordenadoria de Estudos e Captação de Recursos
CECAS - Coordenadoria Regional Estadual de Cascavel
CECTBA - Coordenadoria Regional Estadual de Curitiba
CEGP - Coordenadoria Regional Estadual de Guarapuava
CELDR - Coordenadoria Regional Estadual de Londrina
CEMGA - Coordenadoria Regional Estadual de Maringá
CEPG - Coordenadoria Regional Estadual de Ponta Grossa
CFI – Coordenadoria Financeira
CLC - Coordenadoria de Licitações e Contratos
CMCAS - Coordenadoria Regional Municipal de Cascavel
CMGP - Coordenadoria Regional Municipal de Guarapuava
CMLDR - Coordenadoria Regional Municipal de Londrina
CMMGA - Coordenadoria Regional Municipal de Maringá 
CMPG - Coordenadoria Regional Municipal de Ponta Grossa 
COA – Conselho de Administração
COI – Controladoria Interna
COM – Coordenadoria Operacional Municipal
CPR – Coordenadoria de Projetos
CRH – Coordenadoria de Recursos Humanos
CTI – Coordenadoria de Tecnologia da Informação
DAF – Diretoria de Administração e Finanças
DOM - Diretoria de Operações Municipais
DOE – Diretoria de Operações Estaduais
PJU – Procuradoria Jurídica
SUP – Superintendência
SUPEX - Superintendência Executiva

